block: burokku
walk: aruku
yes: hai
no: iie
older brother: ani
older sister: ane
girlfriend: kanojo
name: namae
his: kare no
her: kanojo no
table: teburu
right: migi
left: hidari
straight: massugu
busy: nigiyaka
quiet: shizuka
or: soretomo
airport: kuukou
bus: basu
train: densha
train station: eki
every morning: maiasa
breakfast: asagohan
lunch: hirugohan
dinner: bangohan
every night: maiban
every day: mainichi
every afternoon: mainichi gogo
by myself: hitoride
music: ongaku
to listen: kikimasu
to drink: nomimasu
to see: mimasu
to buy: kaimasu
to go: ikimasu
to eat: tabemasu
to use: tukaimasu
to get off: orimasu
toilet: toire
washroom: otearai
fun: tanoshi
funny: omoshiroi
kind: yasashi
cheap: yasui
expensive: takai
elevator: erebeetaa
stairs: kaidan
money: okane
cash: genkin
picture: shashin
product/souvenir: omiyage
far: tooi
close: chikai
vending machine: jihanki
exit: deguchi
from: kara no